NO ./path_to_the_north_texture
SO ./path_to_the_south_texture
WE ./path_to_the_west_texture
EA ./path_to_the_east_texture

F 220,100,0
C 225,30,0

	

  
					
          111111111111111111
          100000000000000001
          100011111111111111
          100000000000000011
        11110000000000000001
11111111110000N0000000000001
1000000000000000000000000001
10000000000000000000000000001
1010110101010101010101010101
11111111111111111111111111111
